WE ./game_textures/WE.xpm
SO ./game_textures/SO.xpm
NO ./game_textures/NO.xpm
EA ./game_textures/EA.xpm

F 18,53,25
C 153,204,255

111111111111
111111111111
111111110001
100000010011
10S000000001
111111111111
111111111111
111111111111
