NO game_textures/xpm.xpm
SO game_textures/xpm1.xpm
WE game_textures/xpm2.xpm
EA game_textures/xpm3.xpm



C 83, 60,60
F 83, 60, 61
    
11111111111
00000000000
1100N0D0101
00000000000
00000000000
10000000001
11111111111