NO game_textures/xpm.xpm
SO game_textures/xpm1.xpm
WE game_textures/xpm2.xpm
EA game_textures/xpm3.xpm



C 83, 60,60
F 83, 60, 61
    
11111111111
11111N0D0101
11111111111
10000000001
1111111111