NO game_textures/brick_windows.xpm
SO game_textures/plaster_windows.xpm
WE game_textures/brick_wall.xpm
EA game_textures/brick_ivy.xpm

C 45, 11, 11
F 72, 64, 60

DO game_textures/door.xpm
T1 game_textures/torch-pixel1.xpm
T2 game_textures/torch-pixel2.xpm
T3 game_textures/torch-pixel3.xpm
T4 game_textures/torch-pixel4.xpm
T5 game_textures/torch-pixel5.xpm
T6 game_textures/torch-pixel6.xpm

        1111111111111111111111111
        1001000001110000000000001
        100D000000000000000000001
        1001000000000000000000001
111111111011000001110000000000001
10000000001100000111011011D111111
11110111111111011100000010001
11110111111111011101010010001
11000000110101011100000010001
10000000000000001100000010001
10000000000000001101010010001
11000001110101011111011110N0111
11110111 1110101 101111010001
11111111 1111111 111111111111
