NO texture/xpm.xpm
SO texture/xpm1.xpm
WE texture/xpm2.xpm
EA texture/xpm3.xpm

F 220 ,100                               ,                                                  0
C 225,30,  0

  11111111111   
 100000001111
 100010001111
 1000000011
 1000000011
 1000N00011
 1111111111
