NO texture/xpm.xpm
SO texture/xpm1.xpm
WE texture/xpm2.xpm
EA texture/xpm3.xpm

F 83, 60, 60
C 60, 83, 69

11111111
10000001
1000N001
10000001
10000001
10000001
10000001
11111111
