NO texture/xpm.xpm
SO texture/xpm1.xpm
WE texture/xpm2.xpm
EA texture/xpm3.xpm

F 220 ,100,0
C 225,30,  2

11111111
10100001
10100001
101000011
10000001
1000N101
10000001
11111111
