NO texture/xpm.xpm
SO texture/xpm1.xpm
WE texture/xpm2.xpm
EA texture/xpm3.xpm

F 220          ,100       ,0
C 225,30,  0

        1111 111 1111111111111111
        1000000011110000000000001
        1011000001110000000000001
        1001000000000000000000001
111111111011000001110000000000001
100000000011000001110111111111111
11110111111111011100000010001
11110111111111011101010010001
11000000110101011100000010001
1000000000000000110000001000      01
10000000000000000101010010001
11000001110101010111011110N0111
1111011111101011011111111111
111111   11111  1 1 11 111